------------------
|OP*************O|
|*#*####**####*#*|
|*#************#*|
|*#*#*######*#*#*|
|*#*#********#*#*|
|***#*#****#*#**G|
|*#*#*#*GG*#*#*#*|
|*#*#*#****#*#*#*|
|*#*****G******#*|
|*#*##########*#*|
|O**************O|
------------------